111111111111111111
1000C0000000000011
110000000000010011
111111111101100111
10000C000010010011
101111111111110111
10C00C000P00000E11
111111111111111111
